tract,total,total_no,total_hs,total_col,white,white_no,white_hs,white_col,black,black_no,black_hs,black_col,aian,aian_no,aian_hs,aian_col,asian,asian_no,asian_hs,asian_col,nhpi,nhpi_no,nhpi_hs,nhpi_col,other,other_no,other_hs,other_col,multi,multi_no,multi_hs,multi_col,hisp,hisp_no,hisp_hs,hisp_col
000101,661,0,661,607,553,0,553,499,0,0,0,0,0,0,0,0,52,0,52,52,0,0,0,0,0,0,0,0,0,0,0,0,56,0,56,56
000102,1530,83,1447,1390,1174,18,1156,1117,34,0,34,16,0,0,0,0,99,21,78,78,0,0,0,0,90,13,77,77,10,0,10,10,123,31,92,92
000201,31,0,31,24,0,0,0,0,7,0,7,0,0,0,0,0,24,0,24,24,0,0,0,0,0,0,0,0,0,0,0,0,0,0,0,0
000202,1771,15,1756,1531,1593,15,1578,1353,18,0,18,18,0,0,0,0,58,0,58,58,18,0,18,18,0,0,0,0,12,0,12,12,72,0,72,72
000300,2450,0,2450,2306,1939,0,1939,1856,48,0,48,18,0,0,0,0,143,0,143,112,0,0,0,0,19,0,19,19,89,0,89,89,212,0,212,212
000400,845,168,677,610,499,79,420,382,7,0,7,7,0,0,0,0,213,8,205,196,0,0,0,0,3,1,2,2,14,0,14,8,109,80,29,15
000501,1535,0,1535,1371,1096,0,1096,994,138,0,138,130,0,0,0,0,118,0,118,64,0,0,0,0,2,0,2,2,153,0,153,153,28,0,28,28
000502,1709,18,1691,1440,1237,0,1237,1080,55,0,55,37,28,0,28,28,58,0,58,58,0,0,0,0,44,9,35,29,94,0,94,94,193,9,184,114
000600,2388,74,2314,1991,1594,0,1594,1508,238,28,210,39,0,0,0,0,192,0,192,192,0,0,0,0,57,11,46,46,50,12,38,22,257,23,234,184
000702,1792,38,1754,1458,1136,12,1124,1041,233,26,207,65,15,0,15,0,77,0,77,77,0,0,0,0,21,0,21,21,115,0,115,95,195,0,195,159
000703,1632,43,1589,1390,1214,0,1214,1015,248,23,225,225,0,0,0,0,26,0,26,26,0,0,0,0,0,0,0,0,80,20,60,60,64,0,64,64
000704,1165,49,1116,1043,910,49,861,789,7,0,7,7,0,0,0,0,203,0,203,203,0,0,0,0,0,0,0,0,27,0,27,27,18,0,18,17
000802,1557,14,1543,1403,993,7,986,868,95,0,95,84,0,0,0,0,129,0,129,129,0,0,0,0,53,0,53,53,108,0,108,108,179,7,172,161
000803,1282,0,1282,1176,793,0,793,726,82,0,82,69,0,0,0,0,140,0,140,140,0,0,0,0,32,0,32,32,76,0,76,50,159,0,159,159
000804,1277,0,1277,1160,978,0,978,951,69,0,69,68,0,0,0,0,142,0,142,53,0,0,0,0,11,0,11,11,26,0,26,26,51,0,51,51
000902,964,60,904,824,770,43,727,683,27,1,26,15,0,0,0,0,66,0,66,63,0,0,0,0,0,0,0,0,6,0,6,0,95,16,79,63
000903,502,0,502,438,389,0,389,363,42,0,42,17,0,0,0,0,13,0,13,0,0,0,0,0,0,0,0,0,8,0,8,8,50,0,50,50
000904,1328,74,1254,1074,998,10,988,880,34,0,34,34,0,0,0,0,50,0,50,27,0,0,0,0,45,27,18,0,39,0,39,39,162,37,125,94
001002,1642,86,1556,1468,1157,43,1114,1081,88,0,88,88,0,0,0,0,129,0,129,96,0,0,0,0,13,0,13,13,79,0,79,79,176,43,133,111
001003,1100,4,1096,972,947,4,943,819,19,0,19,19,0,0,0,0,81,0,81,81,0,0,0,0,6,0,6,6,9,0,9,9,38,0,38,38
001004,1582,28,1554,1356,1294,28,1266,1142,105,0,105,31,0,0,0,0,100,0,100,100,0,0,0,0,6,0,6,6,40,0,40,40,37,0,37,37
001100,2333,17,2316,2082,1638,17,1621,1491,272,0,272,261,19,0,19,19,123,0,123,71,0,0,0,0,21,0,21,21,95,0,95,95,165,0,165,124
001200,2345,48,2297,2031,1580,17,1563,1508,164,0,164,164,0,0,0,0,378,31,347,228,0,0,0,0,0,0,0,0,36,0,36,36,187,0,187,95
001301,2448,17,2431,2145,1518,4,1514,1436,367,13,354,259,0,0,0,0,129,0,129,75,0,0,0,0,97,0,97,97,17,0,17,17,320,0,320,261
001303,1982,53,1929,1605,1303,27,1276,1232,191,0,191,161,0,0,0,0,124,26,98,98,0,0,0,0,136,0,136,28,57,0,57,40,171,0,171,46
001304,2262,0,2262,1958,1793,0,1793,1575,105,0,105,105,0,0,0,0,65,0,65,21,0,0,0,0,0,0,0,0,117,0,117,117,182,0,182,140
001401,1554,72,1482,1351,936,46,890,794,90,0,90,90,8,0,8,0,319,0,319,319,0,0,0,0,26,0,26,26,19,0,19,13,156,26,130,109
001402,1602,96,1506,1284,1083,43,1040,917,149,10,139,86,0,0,0,0,49,0,49,41,0,0,0,0,63,0,63,47,18,0,18,15,240,43,197,178
001500,2383,367,2016,1875,1680,8,1672,1542,174,9,165,154,0,0,0,0,68,0,68,68,0,0,0,0,175,175,0,0,62,0,62,62,224,175,49,49
001600,1888,102,1786,1413,478,0,478,409,1188,100,1088,855,0,0,0,0,15,1,14,8,0,0,0,0,0,0,0,0,125,0,125,99,82,1,81,42
001702,1781,57,1724,1239,764,19,745,724,768,38,730,309,0,0,0,0,11,0,11,11,0,0,0,0,52,0,52,41,20,0,20,20,166,0,166,134
001803,1872,533,1339,600,113,7,106,82,1135,120,1015,432,0,0,0,0,2,2,0,0,0,0,0,0,256,195,61,0,72,7,65,60,294,202,92,26
001804,3853,714,3139,1055,198,62,136,118,1752,271,1481,656,0,0,0,0,43,25,18,18,0,0,0,0,675,109,566,7,108,2,106,104,1077,245,832,152
001901,1766,224,1542,898,341,0,341,341,984,36,948,388,0,0,0,0,33,0,33,33,0,0,0,0,94,94,0,0,22,0,22,19,292,94,198,117
001902,1141,113,1028,582,228,0,228,225,568,17,551,216,0,0,0,0,15,4,11,11,0,0,0,0,100,46,54,14,40,0,40,20,190,46,144,96
002001,1537,569,968,363,235,29,206,101,520,32,488,183,0,0,0,0,37,0,37,21,0,0,0,0,312,247,65,21,12,0,12,12,421,261,160,25
002002,1920,76,1844,1110,571,6,565,538,818,40,778,391,0,0,0,0,14,0,14,14,0,0,0,0,71,15,56,7,174,0,174,68,272,15,257,92
002101,2591,707,1884,1035,311,42,269,218,1314,39,1275,595,38,0,38,38,75,0,75,75,0,0,0,0,327,292,35,35,33,0,33,0,493,334,159,74
002102,2790,531,2259,1242,275,44,231,231,1594,75,1519,862,56,56,0,0,20,0,20,20,0,0,0,0,345,128,217,43,29,0,29,17,471,228,243,69
002201,1584,358,1226,619,432,6,426,345,590,30,560,200,23,0,23,0,17,0,17,17,0,0,0,0,191,139,52,0,60,38,22,19,271,145,126,38
002202,1170,113,1057,541,237,30,207,161,643,7,636,251,7,0,7,0,17,0,17,17,0,0,0,0,99,34,65,40,16,0,16,16,151,42,109,56
002301,1710,142,1568,923,317,0,317,304,1043,130,913,354,0,0,0,0,31,0,31,24,0,0,0,0,92,6,86,53,62,0,62,62,165,6,159,126
002302,605,30,575,451,102,0,102,71,401,30,371,278,0,0,0,0,87,0,87,87,0,0,0,0,3,0,3,3,0,0,0,0,12,0,12,12
002400,2005,370,1635,1116,762,76,686,555,754,45,709,402,0,0,0,0,63,0,63,63,0,0,0,0,16,0,16,0,121,70,51,51,289,179,110,45
002501,1306,193,1113,711,311,0,311,289,447,73,374,115,0,0,0,0,34,0,34,25,0,0,0,0,216,57,159,139,20,0,20,0,278,63,215,143
002503,1605,436,1169,714,575,18,557,468,368,84,284,59,0,0,0,0,51,0,51,51,0,0,0,0,176,158,18,0,58,0,58,58,377,176,201,78
002504,1784,579,1205,684,561,121,440,305,294,67,227,161,0,0,0,0,106,0,106,106,0,0,0,0,236,135,101,0,67,0,67,58,520,256,264,54
002600,1249,14,1235,1044,369,0,369,356,595,0,595,533,8,0,8,8,55,0,55,47,0,0,0,0,84,0,84,32,14,7,7,5,124,7,117,63
002702,2731,388,2343,1790,1597,44,1553,1376,247,38,209,59,0,0,0,0,162,0,162,162,0,0,0,0,234,123,111,34,121,31,90,90,370,152,218,69
002703,1191,281,910,713,608,63,545,539,278,50,228,57,0,0,0,0,8,0,8,8,0,0,0,0,71,55,16,16,37,0,37,17,189,113,76,76
002704,1594,222,1372,927,517,0,517,481,634,0,634,236,59,59,0,0,37,0,37,37,0,0,0,0,52,52,0,0,74,0,74,74,221,111,110,99
002801,2026,242,1784,1206,689,9,680,645,468,18,450,185,0,0,0,0,177,12,165,140,0,0,0,0,230,97,133,39,81,0,81,66,381,106,275,131
002802,2591,442,2149,1671,869,43,826,793,527,195,332,59,0,0,0,0,477,31,446,445,0,0,0,0,231,65,166,92,91,0,91,91,396,108,288,191
002900,2053,355,1698,1234,803,55,748,740,503,47,456,171,0,0,0,0,114,0,114,114,0,0,0,0,213,84,129,47,81,14,67,67,339,155,184,95
003000,1992,236,1756,1171,730,31,699,668,754,78,676,243,0,0,0,0,112,0,112,112,0,0,0,0,75,40,35,0,42,8,34,21,279,79,200,127
003100,1890,192,1698,1413,806,0,806,806,436,39,397,143,25,25,0,0,75,14,61,61,0,0,0,0,232,57,175,163,44,0,44,37,272,57,215,203
003200,2533,879,1654,926,504,0,504,474,1033,325,708,252,0,0,0,0,84,1,83,69,0,0,0,0,370,249,121,31,22,0,22,22,520,304,216,78
003301,1641,153,1488,1257,823,30,793,685,585,94,491,377,0,0,0,0,110,0,110,101,0,0,0,0,15,0,15,15,26,0,26,26,82,29,53,53
003302,897,33,864,750,404,0,404,375,365,13,352,291,0,0,0,0,42,10,32,31,0,0,0,0,23,0,23,0,21,0,21,21,42,10,32,32
003400,1576,150,1426,654,347,0,347,339,476,150,326,116,0,0,0,0,30,0,30,30,0,0,0,0,0,0,0,0,442,0,442,162,281,0,281,7
003500,1257,121,1136,720,472,0,472,472,473,43,430,103,2,0,2,2,75,0,75,75,0,0,0,0,64,39,25,0,59,0,59,46,112,39,73,22
003600,2401,267,2134,1831,1173,32,1141,1141,756,203,553,348,0,0,0,0,128,0,128,128,0,0,0,0,66,0,66,17,49,0,49,49,229,32,197,148
003701,872,138,734,562,398,15,383,349,130,50,80,49,0,0,0,0,89,0,89,18,0,0,0,0,35,17,18,0,79,0,79,79,141,56,85,67
003702,1142,142,1000,533,291,0,291,291,674,142,532,89,0,0,0,0,82,0,82,82,0,0,0,0,26,0,26,26,12,0,12,0,57,0,57,45
003801,931,0,931,882,600,0,600,600,41,0,41,12,0,0,0,0,56,0,56,36,0,0,0,0,23,0,23,23,68,0,68,68,143,0,143,143
003802,1368,96,1272,1132,674,58,616,580,131,30,101,35,14,0,14,0,115,0,115,115,0,0,0,0,28,4,24,0,276,0,276,276,130,4,126,126
003901,1401,101,1300,1263,802,46,756,738,464,55,409,390,0,0,0,0,56,0,56,56,0,0,0,0,10,0,10,10,13,0,13,13,56,0,56,56
003902,765,68,697,621,512,8,504,475,47,0,47,0,0,0,0,0,103,60,43,43,0,0,0,0,0,0,0,0,52,0,52,52,51,0,51,51
004001,2008,66,1942,1864,1550,39,1511,1461,137,0,137,137,0,0,0,0,76,0,76,48,0,0,0,0,0,0,0,0,105,0,105,105,140,27,113,113
004002,1842,0,1842,1765,1597,0,1597,1520,59,0,59,59,0,0,0,0,121,0,121,121,0,0,0,0,0,0,0,0,27,0,27,27,38,0,38,38
004100,1247,42,1205,1106,849,0,849,795,42,42,0,0,0,0,0,0,135,0,135,120,0,0,0,0,15,0,15,0,124,0,124,124,82,0,82,67
004201,1636,92,1544,1467,1277,46,1231,1202,77,0,77,67,0,0,0,0,71,0,71,71,0,0,0,0,19,0,19,0,0,0,0,0,192,46,146,127
004202,1178,0,1178,1163,827,0,827,812,15,0,15,15,0,0,0,0,166,0,166,166,0,0,0,0,8,0,8,8,9,0,9,9,153,0,153,153
004300,2018,136,1882,1657,1199,0,1199,1157,300,60,240,104,15,0,15,15,153,0,153,125,0,0,0,0,38,38,0,0,198,0,198,198,115,38,77,58
004401,1319,65,1254,1210,751,0,751,739,268,44,224,192,0,0,0,0,157,0,157,157,0,0,0,0,27,0,27,27,44,0,44,44,72,21,51,51
004402,970,23,947,675,400,0,400,400,222,23,199,90,0,0,0,0,73,0,73,61,0,0,0,0,56,0,56,56,163,0,163,12,56,0,56,56
004600,1234,79,1155,787,391,5,386,372,682,47,635,281,0,0,0,0,104,27,77,77,0,0,0,0,0,0,0,0,34,0,34,34,23,0,23,23
004702,1904,103,1801,1559,1183,0,1183,1146,396,81,315,165,7,0,7,7,102,0,102,102,0,0,0,0,34,11,23,0,50,0,50,41,132,11,121,98
004703,1554,287,1267,740,630,11,619,600,319,37,282,1,0,0,0,0,347,228,119,119,0,0,0,0,104,0,104,0,3,0,3,3,151,11,140,17
004704,705,101,604,103,0,0,0,0,602,101,501,0,0,0,0,0,1,0,1,1,0,0,0,0,0,0,0,0,51,0,51,51,51,0,51,51
004801,1179,70,1109,784,531,11,520,510,501,48,453,204,0,0,0,0,25,0,25,25,0,0,0,0,38,0,38,23,37,0,37,11,47,11,36,11
004802,1529,142,1387,1068,543,2,541,541,518,87,431,155,0,0,0,0,166,27,139,96,0,0,0,0,93,13,80,80,33,0,33,33,176,13,163,163
004901,1351,98,1253,943,794,8,786,767,423,81,342,83,0,0,0,0,26,1,25,25,0,0,0,0,0,0,0,0,5,0,5,5,103,8,95,63
004902,1705,95,1610,1348,834,0,834,834,494,95,399,181,0,0,0,0,191,0,191,173,0,0,0,0,14,0,14,14,51,0,51,38,121,0,121,108
005001,782,32,750,654,499,16,483,473,102,0,102,29,0,0,0,0,114,0,114,114,0,0,0,0,13,0,13,0,15,0,15,15,39,16,23,23
005003,599,47,552,535,302,21,281,281,67,5,62,45,0,0,0,0,90,0,90,90,0,0,0,0,0,0,0,0,86,0,86,86,54,21,33,33
005004,1471,80,1391,976,614,25,589,574,451,30,421,125,0,0,0,0,151,0,151,137,0,0,0,0,29,0,29,16,58,0,58,58,168,25,143,66
005202,1262,18,1244,1164,1034,0,1034,1000,85,18,67,21,0,0,0,0,49,0,49,49,0,0,0,0,0,0,0,0,47,0,47,47,47,0,47,47
005203,2358,0,2358,1246,716,0,716,662,194,0,194,194,508,0,508,0,42,0,42,0,0,0,0,0,135,0,135,135,48,0,48,48,715,0,715,207
005302,1132,0,1132,1132,835,0,835,835,0,0,0,0,0,0,0,0,170,0,170,170,0,0,0,0,50,0,50,50,17,0,17,17,60,0,60,60
005303,1532,0,1532,1426,1052,0,1052,959,33,0,33,33,0,0,0,0,208,0,208,195,0,0,0,0,35,0,35,35,65,0,65,65,139,0,139,139
005501,665,64,601,571,523,32,491,461,0,0,0,0,0,0,0,0,0,0,0,0,0,0,0,0,0,0,0,0,23,0,23,23,119,32,87,87
005502,1188,29,1159,1015,940,6,934,841,67,23,44,6,0,0,0,0,52,0,52,39,0,0,0,0,17,0,17,17,24,0,24,24,88,0,88,88
005503,1088,0,1088,1088,928,0,928,928,0,0,0,0,0,0,0,0,110,0,110,110,0,0,0,0,0,0,0,0,0,0,0,0,50,0,50,50
005601,1013,0,1013,988,436,0,436,411,0,0,0,0,0,0,0,0,126,0,126,126,0,0,0,0,10,0,10,10,215,0,215,215,226,0,226,226
005602,1595,80,1515,1441,792,40,752,689,40,0,40,40,0,0,0,0,430,0,430,430,0,0,0,0,20,0,20,20,110,0,110,110,203,40,163,152
005801,1288,209,1079,750,651,33,618,553,193,20,173,19,0,0,0,0,264,123,141,31,0,0,0,0,15,0,15,15,25,0,25,25,140,33,107,107
005802,937,0,937,855,587,0,587,523,107,0,107,89,0,0,0,0,44,0,44,44,0,0,0,0,0,0,0,0,52,0,52,52,147,0,147,147
005900,788,43,745,590,430,0,430,368,166,43,123,50,0,0,0,0,70,0,70,58,0,0,0,0,24,0,24,24,16,0,16,16,82,0,82,74
006400,1046,277,769,324,175,0,175,159,806,277,529,129,0,0,0,0,1,0,1,1,0,0,0,0,10,0,10,0,17,0,17,8,37,0,37,27
006500,1475,17,1458,1077,1046,0,1046,958,187,17,170,39,0,0,0,0,12,0,12,12,0,0,0,0,65,0,65,0,23,0,23,23,142,0,142,45
006600,913,0,913,822,797,0,797,706,0,0,0,0,0,0,0,0,42,0,42,42,0,0,0,0,0,0,0,0,55,0,55,55,19,0,19,19
006700,1908,54,1854,1628,1455,16,1439,1370,286,38,248,129,0,0,0,0,106,0,106,90,0,0,0,0,0,0,0,0,0,0,0,0,61,0,61,39
006801,1156,34,1122,856,522,0,522,491,353,18,335,149,0,0,0,0,98,0,98,64,0,0,0,0,26,14,12,12,23,1,22,22,134,1,133,118
006802,1020,0,1020,872,536,0,536,526,415,0,415,277,0,0,0,0,17,0,17,17,0,0,0,0,7,0,7,7,16,0,16,16,29,0,29,29
006804,432,74,358,126,119,4,115,53,277,66,211,62,11,0,11,11,0,0,0,0,0,0,0,0,0,0,0,0,0,0,0,0,25,4,21,0
006900,986,14,972,834,746,0,746,711,195,14,181,78,0,0,0,0,10,0,10,10,0,0,0,0,0,0,0,0,30,0,30,30,5,0,5,5
007000,1048,80,968,852,759,22,737,722,101,0,101,0,0,0,0,0,53,0,53,53,0,0,0,0,34,21,13,13,14,0,14,14,87,37,50,50
007100,1238,120,1118,676,373,7,366,359,651,104,547,136,0,0,0,0,114,0,114,114,0,0,0,0,0,0,0,0,60,9,51,51,40,0,40,16
007201,647,0,647,555,421,0,421,379,118,0,118,68,0,0,0,0,0,0,0,0,0,0,0,0,0,0,0,0,60,0,60,60,48,0,48,48
007202,1721,55,1666,1594,1388,0,1388,1360,78,23,55,38,0,0,0,0,71,0,71,44,0,0,0,0,16,16,0,0,40,0,40,40,128,16,112,112
007203,1192,51,1141,924,652,0,652,619,376,51,325,141,0,0,0,0,95,0,95,95,0,0,0,0,0,0,0,0,20,0,20,20,49,0,49,49
007301,1209,0,1209,734,690,0,690,477,183,0,183,72,0,0,0,0,125,0,125,73,0,0,0,0,37,0,37,13,31,0,31,23,143,0,143,76
007304,1452,303,1149,197,85,13,72,62,1312,248,1064,122,0,0,0,0,0,0,0,0,0,0,0,0,21,21,0,0,0,0,0,0,34,21,13,13
007401,610,86,524,66,33,0,33,15,485,51,434,33,0,0,0,0,28,0,28,18,0,0,0,0,38,22,16,0,0,0,0,0,26,13,13,0
007403,888,109,779,66,0,0,0,0,861,108,753,66,0,0,0,0,0,0,0,0,0,0,0,0,17,1,16,0,0,0,0,0,10,0,10,0
007404,1370,161,1209,201,8,0,8,0,1226,161,1065,159,0,0,0,0,0,0,0,0,0,0,0,0,61,0,61,16,21,0,21,10,54,0,54,16
007406,1341,73,1268,243,0,0,0,0,1166,23,1143,197,0,0,0,0,0,0,0,0,0,0,0,0,83,25,58,28,30,0,30,11,62,25,37,7
007407,1597,274,1323,391,40,1,39,18,1487,251,1236,338,0,0,0,0,4,0,4,0,0,0,0,0,0,0,0,0,24,0,24,24,42,22,20,11
007408,787,139,648,130,0,0,0,0,753,139,614,112,18,0,18,18,0,0,0,0,0,0,0,0,16,0,16,0,0,0,0,0,0,0,0,0
007409,1582,214,1368,190,9,0,9,9,1358,91,1267,151,0,0,0,0,38,0,38,30,0,0,0,0,47,47,0,0,83,29,54,0,47,47,0,0
007502,1723,251,1472,210,28,14,14,14,1689,237,1452,196,0,0,0,0,0,0,0,0,0,0,0,0,0,0,0,0,6,0,6,0,0,0,0,0
007503,883,130,753,145,79,0,79,50,748,130,618,95,0,0,0,0,0,0,0,0,0,0,0,0,0,0,0,0,7,0,7,0,49,0,49,0
007504,820,179,641,142,0,0,0,0,773,141,632,133,9,0,9,9,0,0,0,0,0,0,0,0,0,0,0,0,19,19,0,0,19,19,0,0
007601,2264,332,1932,732,161,42,119,101,1877,290,1587,495,0,0,0,0,0,0,0,0,0,0,0,0,46,0,46,46,66,0,66,27,114,0,114,63
007603,2073,206,1867,1064,50,0,50,13,1952,206,1746,996,0,0,0,0,22,0,22,21,0,0,0,0,0,0,0,0,28,0,28,13,21,0,21,21
007604,1803,73,1730,567,73,0,73,55,1630,51,1579,466,0,0,0,0,19,0,19,8,0,0,0,0,0,0,0,0,81,22,59,38,0,0,0,0
007605,2020,156,1864,551,106,0,106,62,1745,156,1589,374,0,0,0,0,6,0,6,6,0,0,0,0,27,0,27,0,66,0,66,66,70,0,70,43
007703,2587,318,2269,286,0,0,0,0,2344,200,2144,251,0,0,0,0,0,0,0,0,0,0,0,0,104,59,45,0,12,0,12,12,127,59,68,23
007707,1435,133,1302,326,29,3,26,26,1365,110,1255,297,0,0,0,0,0,0,0,0,0,0,0,0,0,0,0,0,41,20,21,3,0,0,0,0
007708,1088,116,972,62,0,0,0,0,1062,116,946,62,0,0,0,0,0,0,0,0,0,0,0,0,0,0,0,0,26,0,26,0,0,0,0,0
007709,867,152,715,157,13,0,13,11,786,152,634,136,61,0,61,5,0,0,0,0,0,0,0,0,0,0,0,0,0,0,0,0,7,0,7,5
007803,1673,271,1402,285,20,0,20,12,1556,271,1285,234,0,0,0,0,25,0,25,25,0,0,0,0,23,0,23,0,26,0,26,14,23,0,23,0
007804,1428,123,1305,298,26,6,20,14,1333,117,1216,275,0,0,0,0,7,0,7,7,0,0,0,0,0,0,0,0,62,0,62,2,0,0,0,0
007806,1057,80,977,434,66,0,66,59,962,80,882,353,0,0,0,0,0,0,0,0,0,0,0,0,0,0,0,0,22,0,22,22,7,0,7,0
007807,776,117,659,103,1,0,1,1,741,110,631,101,0,0,0,0,0,0,0,0,0,0,0,0,10,0,10,0,13,7,6,0,11,0,11,1
007808,1474,168,1306,387,18,0,18,18,1403,168,1235,364,0,0,0,0,0,0,0,0,0,0,0,0,15,0,15,0,0,0,0,0,38,0,38,5
007809,1121,196,925,201,1,0,1,0,1074,196,878,201,0,0,0,0,0,0,0,0,0,0,0,0,0,0,0,0,14,0,14,0,32,0,32,0
007901,1863,167,1696,822,477,0,477,446,1119,152,967,151,0,0,0,0,11,0,11,11,0,0,0,0,14,0,14,14,204,0,204,177,38,15,23,23
007903,833,26,807,356,184,0,184,184,617,26,591,149,0,0,0,0,25,0,25,16,0,0,0,0,0,0,0,0,0,0,0,0,7,0,7,7
008001,1299,57,1242,920,778,0,778,720,384,57,327,94,0,0,0,0,33,0,33,18,0,0,0,0,0,0,0,0,38,0,38,38,66,0,66,50
008002,1343,19,1324,1129,978,0,978,960,244,19,225,48,0,0,0,0,19,0,19,19,0,0,0,0,0,0,0,0,16,0,16,16,86,0,86,86
008100,1525,0,1525,1395,1271,0,1271,1227,92,0,92,37,0,0,0,0,37,0,37,37,0,0,0,0,24,0,24,0,42,0,42,35,59,0,59,59
008200,1412,0,1412,1376,1141,0,1141,1114,72,0,72,63,0,0,0,0,23,0,23,23,0,0,0,0,37,0,37,37,44,0,44,44,95,0,95,95
008301,911,0,911,822,732,0,732,695,106,0,106,54,0,0,0,0,24,0,24,24,0,0,0,0,12,0,12,12,0,0,0,0,37,0,37,37
008302,1095,40,1055,953,779,2,777,731,93,38,55,15,0,0,0,0,8,0,8,8,0,0,0,0,51,0,51,43,62,0,62,62,102,0,102,94
008402,1206,56,1150,915,639,0,639,624,478,56,422,202,0,0,0,0,0,0,0,0,0,0,0,0,9,0,9,9,34,0,34,34,46,0,46,46
008410,764,12,752,660,492,0,492,492,182,12,170,78,0,0,0,0,16,0,16,16,0,0,0,0,0,0,0,0,59,0,59,59,15,0,15,15
008701,1136,46,1090,849,411,0,411,411,652,41,611,370,0,0,0,0,36,5,31,31,0,0,0,0,5,0,5,5,14,0,14,14,18,0,18,18
008702,1786,71,1715,1148,605,17,588,518,839,37,802,396,0,0,0,0,107,0,107,67,0,0,0,0,0,0,0,0,125,0,125,125,110,17,93,42
008802,1646,171,1475,755,422,4,418,376,1140,167,973,315,0,0,0,0,27,0,27,20,0,0,0,0,0,0,0,0,0,0,0,0,57,0,57,44
008803,797,98,699,290,79,0,79,64,537,50,487,156,0,0,0,0,0,0,0,0,0,0,0,0,58,24,34,6,35,0,35,34,88,24,64,30
008804,1202,188,1014,519,134,28,106,66,943,132,811,363,7,0,7,0,0,0,0,0,0,0,0,0,0,0,0,0,62,0,62,62,56,28,28,28
008903,1138,59,1079,484,201,0,201,173,793,59,734,227,0,0,0,0,0,0,0,0,0,0,0,0,30,0,30,0,54,0,54,54,60,0,60,30
008904,1567,267,1300,504,303,41,262,259,992,133,859,162,0,0,0,0,6,0,6,6,0,0,0,0,65,26,39,14,67,0,67,36,134,67,67,27
009000,2088,227,1861,978,156,16,140,127,1755,186,1569,705,0,0,0,0,39,0,39,39,69,0,69,69,2,0,2,2,6,0,6,0,61,25,36,36
009102,1803,262,1541,598,189,0,189,115,1347,262,1085,371,16,0,16,16,67,0,67,67,0,0,0,0,0,0,0,0,92,0,92,28,92,0,92,1
009201,997,67,930,741,425,0,425,404,409,48,361,203,0,0,0,0,53,6,47,47,0,0,0,0,4,0,4,3,39,0,39,39,67,13,54,45
009203,1463,74,1389,690,357,0,357,219,971,74,897,367,11,0,11,11,9,0,9,9,0,0,0,0,27,0,27,27,36,0,36,36,52,0,52,21
009204,1237,387,850,266,136,0,136,136,891,253,638,122,0,0,0,0,0,0,0,0,0,0,0,0,100,66,34,0,9,1,8,8,101,67,34,0
009301,1327,0,1327,931,599,0,599,504,550,0,550,317,0,0,0,0,116,0,116,69,0,0,0,0,0,0,0,0,46,0,46,25,16,0,16,16
009302,679,102,577,387,177,34,143,143,344,12,332,231,0,0,0,0,0,0,0,0,10,0,10,0,35,11,24,0,3,0,3,3,110,45,65,10
009400,2207,136,2071,1409,409,5,404,386,1661,108,1553,932,0,0,0,0,8,8,0,0,0,0,0,0,59,5,54,54,8,0,8,8,62,10,52,29
009503,1265,78,1187,763,228,0,228,219,1004,78,926,526,0,0,0,0,33,0,33,18,0,0,0,0,0,0,0,0,0,0,0,0,0,0,0,0
009504,1554,124,1430,945,311,28,283,259,840,96,744,331,0,0,0,0,292,0,292,278,0,0,0,0,28,0,28,11,10,0,10,10,73,0,73,56
009505,1874,115,1759,745,101,0,101,79,1487,39,1448,491,6,0,6,0,46,0,46,39,0,0,0,0,46,23,23,8,127,15,112,112,61,38,23,16
009507,744,70,674,264,26,0,26,26,571,20,551,169,0,0,0,0,0,0,0,0,0,0,0,0,62,25,37,23,23,0,23,23,62,25,37,23
009508,2119,200,1919,576,95,0,95,70,1631,82,1549,429,34,15,19,0,21,11,10,1,0,0,0,0,95,32,63,0,85,14,71,52,158,46,112,24
009509,1488,169,1319,692,178,0,178,167,1173,75,1098,525,0,0,0,0,0,0,0,0,0,0,0,0,78,47,31,0,0,0,0,0,59,47,12,0
009510,1885,237,1648,382,95,0,95,79,1274,98,1176,181,12,0,12,12,26,0,26,13,0,0,0,0,198,53,145,24,49,0,49,49,231,86,145,24
009511,85,7,78,47,37,0,37,25,21,7,14,7,0,0,0,0,0,0,0,0,0,0,0,0,0,0,0,0,10,0,10,4,17,0,17,11
009601,1073,131,942,268,34,20,14,12,920,111,809,205,0,0,0,0,0,0,0,0,0,0,0,0,10,0,10,0,52,0,52,28,57,0,57,23
009602,1628,140,1488,266,61,0,61,61,1481,140,1341,163,0,0,0,0,0,0,0,0,0,0,0,0,0,0,0,0,12,0,12,0,74,0,74,42
009603,1660,146,1514,216,0,0,0,0,1617,146,1471,199,0,0,0,0,0,0,0,0,0,0,0,0,16,0,16,0,21,0,21,11,6,0,6,6
009604,1126,99,1027,220,61,7,54,48,1025,81,944,168,11,0,11,4,0,0,0,0,0,0,0,0,5,0,5,0,8,2,6,0,16,9,7,0
009700,1232,23,1209,555,10,0,10,0,1222,23,1199,555,0,0,0,0,0,0,0,0,0,0,0,0,0,0,0,0,0,0,0,0,0,0,0,0
009801,1015,331,684,70,24,0,24,6,833,317,516,20,34,7,27,19,0,0,0,0,0,0,0,0,0,0,0,0,44,0,44,0,80,7,73,25
009802,888,112,776,116,26,17,9,0,827,60,767,116,0,0,0,0,0,0,0,0,0,0,0,0,9,9,0,0,0,0,0,0,26,26,0,0
009803,1147,20,1127,155,23,0,23,10,1083,20,1063,104,0,0,0,0,0,0,0,0,0,0,0,0,0,0,0,0,27,0,27,27,14,0,14,14
009804,993,70,923,181,14,0,14,7,902,65,837,136,0,0,0,0,6,0,6,6,0,0,0,0,12,0,12,0,15,5,10,0,44,0,44,32
009807,1241,74,1167,246,33,2,31,26,1193,72,1121,220,0,0,0,0,0,0,0,0,0,0,0,0,0,0,0,0,15,0,15,0,0,0,0,0
009810,674,33,641,89,3,0,3,0,671,33,638,89,0,0,0,0,0,0,0,0,0,0,0,0,0,0,0,0,0,0,0,0,0,0,0,0
009811,1655,284,1371,93,0,0,0,0,1624,284,1340,74,0,0,0,0,0,0,0,0,0,0,0,0,0,0,0,0,31,0,31,19,0,0,0,0
009901,1122,70,1052,554,74,9,65,65,860,61,799,343,0,0,0,0,43,0,43,32,0,0,0,0,135,0,135,104,0,0,0,0,10,0,10,10
009902,1377,131,1246,296,24,2,22,14,1353,129,1224,282,0,0,0,0,0,0,0,0,0,0,0,0,0,0,0,0,0,0,0,0,0,0,0,0
009903,822,71,751,289,60,0,60,60,751,71,680,218,0,0,0,0,0,0,0,0,0,0,0,0,0,0,0,0,0,0,0,0,11,0,11,11
009904,1009,127,882,169,6,0,6,3,862,67,795,141,0,0,0,0,0,0,0,0,0,0,0,0,31,30,1,0,28,0,28,25,82,30,52,0
009905,908,70,838,198,3,0,3,2,846,70,776,196,0,0,0,0,0,0,0,0,0,0,0,0,21,0,21,0,38,0,38,0,0,0,0,0
009906,834,97,737,178,59,7,52,52,730,90,640,90,0,0,0,0,0,0,0,0,0,0,0,0,0,0,0,0,16,0,16,7,29,0,29,29
009907,972,91,881,171,0,0,0,0,932,91,841,131,0,0,0,0,0,0,0,0,0,0,0,0,0,0,0,0,20,0,20,20,20,0,20,20
010100,1522,65,1457,1255,831,0,831,798,62,7,55,55,0,0,0,0,205,0,205,193,0,0,0,0,73,0,73,22,109,29,80,62,242,29,213,125
010201,940,17,923,812,469,0,469,409,216,17,199,148,0,0,0,0,62,0,62,62,0,0,0,0,38,0,38,38,57,0,57,57,98,0,98,98
010202,867,25,842,618,525,0,525,430,268,25,243,122,0,0,0,0,29,0,29,29,0,0,0,0,2,0,2,2,0,0,0,0,43,0,43,35
010300,1921,268,1653,1009,306,0,306,287,1080,88,992,467,30,30,0,0,25,0,25,25,0,0,0,0,181,60,121,71,43,0,43,43,256,90,166,116
010400,2131,98,2033,471,316,0,316,0,1775,98,1677,471,0,0,0,0,0,0,0,0,0,0,0,0,0,0,0,0,4,0,4,0,36,0,36,0
010500,1699,181,1518,1265,920,19,901,872,463,149,314,140,0,0,0,0,103,0,103,103,8,0,8,8,19,0,19,19,73,13,60,35,113,0,113,88
010601,802,109,693,464,256,0,256,204,300,109,191,71,0,0,0,0,54,0,54,54,0,0,0,0,68,0,68,11,82,0,82,82,42,0,42,42
010602,2282,113,2169,1777,1172,0,1172,1166,675,92,583,220,0,0,0,0,275,0,275,252,0,0,0,0,0,0,0,0,91,21,70,70,69,0,69,69
010603,942,20,922,871,708,0,708,685,122,20,102,97,0,0,0,0,15,0,15,15,0,0,0,0,0,0,0,0,36,0,36,36,61,0,61,38
010700,826,0,826,747,644,0,644,573,42,0,42,36,0,0,0,0,30,0,30,30,0,0,0,0,21,0,21,21,2,0,2,0,87,0,87,87
010800,380,16,364,310,149,0,149,134,13,6,7,7,19,0,19,0,124,10,114,105,0,0,0,0,18,0,18,18,29,0,29,21,28,0,28,25
010900,1011,111,900,173,0,0,0,0,966,111,855,159,0,0,0,0,0,0,0,0,0,0,0,0,0,0,0,0,36,0,36,14,9,0,9,0
011001,1475,111,1364,1100,813,16,797,722,352,49,303,198,0,0,0,0,29,0,29,29,0,0,0,0,0,0,0,0,64,46,18,0,217,0,217,151
011002,1035,19,1016,745,705,19,686,469,203,0,203,149,0,0,0,0,16,0,16,16,0,0,0,0,14,0,14,14,83,0,83,83,14,0,14,14
011100,2251,231,2020,1077,308,25,283,168,1338,151,1187,520,0,0,0,0,72,21,51,31,0,0,0,0,27,0,27,0,153,0,153,140,353,34,319,218
980000,0,0,0,0,0,0,0,0,0,0,0,0,0,0,0,0,0,0,0,0,0,0,0,0,0,0,0,0,0,0,0,0,0,0,0,0
